border_size=1
usage=map

Gll^Fp      , Gll^Fp      , Gll^Fp      , Gg          , Gs^Fp       , Gs^Fp       , Gs^Fp       , Gs^Fp       , Rp          , Gs^Fp       , Gg          , Gs^Fp       , Gs^Fp       , Gs^Fp       , Gg          , Gg          , Gg          , Gg          , Hh          , Md          , Wo          , Wo          , Hh          , Mm          
Gll^Fp      , Gll^Fp      , Ss          , Gs^Fp       , Gs^Fp       , Gs^Fp       , Gs^Fp       , Rp          , Gs^Fp       , Gs^Fp       , Gs^Fp       , Gs^Fp       , Gs^Fp       , Gs^Fp       , Gg          , Gg          , Hhd         , Gs^Fp       , Md          , Mm          , Wo          , Mm          , 5 Mm        , Mm          
Gll^Fp      , Gll^Fp      , Gs^Fp       , Gs^Fp       , Gs^Fds      , Gs^Fp       , Re          , Re          , Gg          , Gs^Fp       , Gs^Fp       , Gs^Fp       , Ds          , Ds          , Ds          , Ds          , Hh          , Hh          , Wo          , Wo          , Mm          , Mm          , Gs^Fp       , Xue         
Gll^Fp      , Gs^Fp       , Gs^Fp       , Gs^Fds      , Gg          , Gs^Fp       , Rb          , Gg          , Ss          , Gs^Fp       , Gs^Fp       , Gs^Fp       , Ds          , Wo          , Wo          , Wo          , Wwrg        , Wwrg        , Hh          , Gs^Fp       , Mm          , Ms          , Xue         , Xue         
Gll^Fp      , Gs          , Re          , Re          , 4 Re        , Re          , Ss          , Ss          , Ss          , Gs^Fp       , Gs^Fp       , Gs^Fp       , Ss          , Wo          , Ss          , Wo          , Hh          , Mm          , Gs^Fp       , Hh          , Mm          , Mm          , Xue         , Xue         
Gg          , Gg          , 1 Rp        , Gg^Fet      , Gg          , Gs^Fp       , Gs^Fp       , Gs^Fp       , Gs^Fp       , Gs^Fp       , Gs^Fp       , Gs^Fp       , Ss          , Ss          , Wwrg        , Wwrg        , Ds          , Hh          , Gs^Fp       , Gs^Fp       , Mm          , Xue         , Xue         , Xue         
Rr          , 3 Rp        , Gg          , Gg          , Gll^Fp      , Gg          , Gs^Fp       , Gs^Fp       , Gs^Fp       , Gg          , Gg          , Gs^Fp       , Ss          , Ss          , Wwrg        , Ss          , Gs^Fp       , Mm          , Mm          , Mm          , Xue         , Xue         , Xue         , Xue         
Gg          , Rr          , Gs          , Gll^Fp      , Gg          , Gg          , Gg          , Gs^Fds      , Gll         , Gg          , Gg          , Gs^Fp       , Ww          , Ww          , Ss          , Wwrg        , Mm          , Mm          , Mm^Xm       , Xue         , Xue         , Xue         , Xue         , Xue         
Gll^Fp      , Gg          , Gg          , 2 Gs        , Gll^Fp      , Gg          , Gg          , Gll         , Gg          , Gll         , Wwrg        , Wwrg        , Gs          , Gg          , Gll         , Ss          , Mm          , Mm          , Xue         , Xue         , Xue         , Xue         , Xue         , Xue         
Hh          , Hh          , Hh          , Gll^Fp      , Gll^Fp      , Gg          , Wwf         , Gll^Fp      , Ww          , Wwf         , Wwf         , Wwrg        , Gs^Fp       , Ss          , Ss          , Gll         , Gg          , Hhd         , Hhd         , Hhd         , Uue         , Xue         , Xue         , Xue         
Hh          , Mm          , Ww          , Gll^Fp      , Ww          , Wwrg        , Wwf         , Ww          , Ss          , Ss          , Ww          , Gg          , Gs^Fp       , Gs^Fp       , Ss          , Ss          , Mm          , Rd          , Uue         , Uu          , Uu          , Xue         , Xue         , Xue         
Ww          , Ww          , Wwrg        , Ww          , Ss          , Ss          , Gg          , Gll         , Ss          , Ss          , Ww          , Gs^Fp       , Gg          , Gs^Fp       , Mm          , Mm^Xm       , Xue         , Xue         , Uue         , Uu          , Uu          , Xue         , Xue         , Xue         
Hh          , Hh          , Hh          , Gs^Fp       , Gg          , Gg          , Gll         , Gg          , Ss          , Ww          , Ss          , Gs^Fp       , Xue         , Mm          , Uu          , Xue         , Uu          , Uu          , Xue         , Hhd         , Uue         , Uu          , Xue         , Xue         
Hh          , Hh          , Hh          , Gs^Fp       , Gs^Fp       , Gs          , Gs          , Gg          , Ss          , Wwrg        , Ds          , Gs^Fp       , Xue         , Uu          , Uu          , Uu          , Uu          , Xue         , Xue         , Xue         , Uu          , Uu          , Hhd         , Xue         
Xue         , Hh^Fp       , Hh^Fp       , Hh^Fp       , Hh^Fp       , Hh          , Hh          , Gg          , Wwf         , Wwf         , Hh          , Ss          , Xue         , Uu          , Uu          , Uu          , Uu          , Xue         , Xue         , Xue         , Uu          , Wo          , Uue         , Xue         
Xue         , Xue         , Hh^Fp       , Gs^Fp       , Mm          , Mm          , Hh          , Ds          , Wwrg        , Hh          , Hh          , Xue         , Uu          , Uu          , Xue         , Uu          , Xue         , Xue         , Xue         , Uu          , Uu          , Wo          , Uue         , Xue         
Xue         , Xue         , Xue         , Xue         , Ms^Xm       , Ms          , Xue         , Xue         , Xue         , Wwrg        , Ww          , Xue         , Uu          , Uu          , Xue         , Xue         , Xue         , Uu          , Uu          , Uu          , Uu          , Uue         , Xue         , Xue         
Xue         , Xue         , Xue         , Gs^Fp       , Gs^Fp       , Ms^Xm       , Xue         , Xue         , Xue         , Wwf         , Wwrg        , Uu          , Uu          , Uu          , Xue         , Xue         , Xue         , Uu          , Uu          , Uu          , Uu          , Xue         , Xue         , Xue         
Xue         , Xue         , Xue         , Xue         , Gs^Fp       , Xue         , Xue         , Xue         , Xue         , Xue         , Uu          , Uu          , Uu          , Uu          , Xue         , Xue         , Xue         , Uu          , Uu          , Uu          , Uu          , Xue         , Xue         , Xue         
Xue         , Xue         , Xue         , Xue         , Xue         , Xue         , Xue         , Xue         , Xue         , Xue         , Xue         , Uu          , Uu          , Ds          , Wo          , Ds          , Ds          , Uu          , Uu          , Uu          , Xue         , Xue         , Xue         , Xue         
Xue         , Xue         , Xue         , Uu          , Uu          , Uu          , Xue         , Xue         , Xue         , Hh          , Gg          , Xue         , Xue         , Xue         , Xue         , Xue         , Xue         , Xue         , Xue         , Uu          , Xue         , Xue         , Xue         , Xue         
Xue         , Xue         , Xue         , Xue         , Uu          , Uu          , Hh          , Hh          , Xue         , Xue         , Uue         , Aa          , Aa          , Uu          , Uu          , Uu          , Xue         , Xue         , Xue         , Xue         , Xue         , Xue         , Xue         , Xue         
Xue         , Xue         , Xue         , Xue         , Uu          , Hh          , Uue         , Uue         , Xue         , Xue         , Xue         , Uue         , Aa          , Uu          , Uu          , Uu          , Uu          , Xue         , Xue         , Xue         , Xue         , Xue         , Xue         , Xue         
Xue         , Xue         , Xue         , Xue         , Uue         , Uue         , Uue         , Uue         , Xue         , Xue         , Xue         , Uue         , Aa          , Uu          , Uu          , Gs^Fp       , Gs^Fp       , Uu          , Uu          , Xue         , Xue         , Xue         , Xue         , Xue         
Xue         , Xue         , Xue         , Xue         , Uue         , Uue         , Uue         , Uue         , Uue         , Xue         , Xue         , Xue         , Uu          , Uu          , Uu          , Gs^Fp       , Gs^Fp       , Uu          , Uu          , Xue         , Xue         , Xue         , Xue         , Xue         
Xue         , Xue         , Xue         , Xue         , Xue         , Uue         , Uue         , Uue         , Xue         , Xue         , Xue         , Xue         , Ha          , Hh          , Uu          , Uu          , Uu          , Uu          , Uu          , Xue         , Xue         , Xue         , Xue         , Xue         
Xue         , Xue         , Xue         , Xue         , Xue         , Uue         , Xue         , Xue         , Xue         , Xue         , Xue         , Xue         , Xue         , Xue         , Uue         , Uue         , Uu          , Uu          , Hh          , Xue         , Xue         , Xue         , Xue         , Xue         
Xue         , Xue         , Xue         , Xue         , Xue         , Xue         , Xue         , Xue         , Xue         , Xue         , Xue         , Xue         , Xue         , Xue         , Xue         , Ai          , Ai          , Ai          , Xue         , Xue         , Xue         , Xue         , Xue         , Xue         
Xue         , Xue         , Xue         , Xue         , Xue         , Xue         , Xue         , Xue         , Xue         , Xue         , Xue         , Xue         , Xue         , Xue         , Xue         , Xue         , Xue         , Xue         , Xue         , Xue         , Xue         , Xue         , Xue         , Xue         
Xue         , Xue         , Xue         , Xue         , Xue         , Xue         , Xue         , Xue         , Xue         , Xue         , Xue         , Xue         , Xue         , Xue         , Xue         , Xue         , Xue         , Xue         , Xue         , Xue         , Xue         , Xue         , Xue         , Xue         
Xue         , Xue         , Xue         , Xue         , Xue         , Xue         , Xue         , Xue         , Xue         , Xue         , Xue         , Xue         , Xue         , Xue         , Xue         , Xue         , Xue         , Xue         , Xue         , Xue         , Xue         , Xue         , Xue         , Xue         
Xue         , Xue         , Xue         , Xue         , Xue         , Xue         , Xue         , Xue         , Xue         , Xue         , Xue         , Xue         , Xue         , Xue         , Xue         , Xue         , Xue         , Xue         , Xue         , Xue         , Xue         , Xue         , Xue         , Xue         
Xue         , Xue         , Xue         , Xue         , Xue         , Xue         , Xue         , Xue         , Xue         , Xue         , Xue         , Xue         , Xue         , Xue         , Xue         , Xue         , Xue         , Xue         , Xue         , Xue         , Xue         , Xue         , Xue         , Xue         
Xue         , Xue         , Xue         , Xue         , Xue         , Xue         , Xue         , Xue         , Xue         , Xue         , Xue         , Xue         , Xue         , Xue         , Xue         , Xue         , Xue         , Xue         , Xue         , Xue         , Xue         , Xue         , Xue         , Xue         
Xue         , Xue         , Xue         , Xue         , Xue         , Xue         , Xue         , Xue         , Xue         , Xue         , Xue         , Xue         , Xue         , Xue         , Xue         , Xue         , Xue         , Xue         , Xue         , Xue         , Xue         , Xue         , Xue         , Xue         
